{'.','.','.','.','.','.','.','.','.','.','.','.','.','.','.','.','.','.','.','.','.','.','.','.','.','.','.','.','.','.','.','.','.','.','.','.','.','.','.','.','.','.','.','.','.','.','.','.','.','.','.','.','.','.','.','.','.','.','.','.','.','.','.','.','.','.','.','.','.','.','.','.','.','.','.','.','.','.','.','.'},
{'.','.','.','.','.','.','.','.','.','.','.','.','.','.','.','.','.','.','.','.','.','.','.','.','.','.','.','.','.','.','.','.','.','.','.','.','.','.','.','.','.','.','.','.','.','.','.','.','.','.','.','.','.','.','.','.','.','.','.','.','.','.','.','.','.','.','.','.','.','.','.','.','.','.','.','.','.','.','.','.'},
{'.','.','.','.','.','.','.','.','.','.','.','.','.','.','.','.','.','.','.','.','.','.','.','.','.','.','.','.','.','.','.','.','.','.','.','.','.','.','.','.','.','.','.','.','.','.','.','.','.','.','.','.','.','.','.','.','.','.','.','.','.','.','.','.','.','.','.','.','.','.','.','.','.','.','.','.','.','.','.','.'},
{'.','.','.','.','.','.','.','.','.','.','.','.','.','.','.','.','.','.','.','.','.','.','.','.','.','.','.','.','.','.','.','.','.','.','.','.','.','.','.','.','.','.','.','.','.','.','.','.','.','.','.','.','.','.','.','.','.','.','.','.','.','.','.','.','.','.','.','.','.','.','.','.','.','.','.','.','.','.','.','.'},
{'.','.','.','.','.','.','.','.','.','.','.','.','.','.','.','.','.','.','.','.','.','.','.','.','.','.','.','.','.','.','.','.','.','.','.','.','.','.','.','.','.','.','.','.','.','.','.','.','.','.','.','.','.','.','.','.','.','.','.','.','.','.','.','.','.','.','.','.','.','.','.','.','.','.','.','.','.','.','.','.'},
{'.','.','.','.','.','.','.','.','.','.','.','.','.','.','.','.','.','.','.','.','.','.','.','.','.','.','.','.','.','.','.','.','.','.','.','.','.','.','.','.','.','.','.','.','.','.','.','.','.','.','.','.','.','.','.','.','.','.','.','.','.','.','.','.','.','.','.','.','.','.','.','.','.','.','.','.','.','.','.','.'},
{'.','.','.','.','.','.','.','.','.','.','.','.','.','.','.','.','.','.','.','.','.','.','.','.','.','.','.','.','.','.','.','.','.','.','.','.','.','.','.','.','.','.','.','.','.','.','.','.','.','.','.','.','.','.','.','.','.','.','.','.','.','.','.','.','.','.','.','.','.','.','.','.','.','.','.','.','.','.','.','.'},
{'.','.','.','.','.','.','.','.','.','.','.','.','.','.','.','.','.','.','.','.','.','.','.','.','.','.','.','.','.','.','.','.','.','.','.','.','.','.','.','.','.','.','.','.','.','.','.','.','.','.','.','.','.','.','.','.','.','.','.','.','.','.','.','.','.','.','.','.','.','.','.','.','.','.','.','.','.','.','.','.'},
{'.','.','.','.','.','.','.','.','.','.','.','.','.','.','.','.','.','.','.','.','.','.','.','.','.','.','.','.','.','.','.','.','.','.','.','.','.','.','.','.','.','.','.','.','.','.','.','.','.','.','.','.','.','.','.','.','.','.','.','.','.','.','.','.','.','.','.','.','.','.','.','.','.','.','.','.','.','.','.','.'},
{'.','.','.','.','.','.','.','.','.','.','.','.','.','.','.','.','.','.','.','.','.','.','.','.','.','.','.','.','.','.','.','.','.','.','.','.','.','.','.','.','.','.','.','.','.','.','.','.','.','.','.','.','.','.','.','.','.','.','.','.','.','.','.','.','.','.','.','.','.','.','.','.','.','.','.','.','.','.','.','.'},
{'.','.','.','.','.','.','.','.','.','.','.','.','.','.','.','.','.','.','.','.','.','.','.','.','.','.','.','.','.','.','.','.','.','.','.','.','.','.','.','.','.','.','.','.','.','.','.','.','.','.','.','.','.','.','.','.','.','.','.','.','.','.','.','.','.','.','.','.','.','.','.','.','.','.','.','.','.','.','.','.'},
{'.','.','.','.','.','.','.','.','.','.','.','.','.','.','.','.','.','.','.','.','.','.','.','.','.','.','.','.','.','.','.','.','.','.','.','.','.','.','.','.','.','.','.','.','.','.','.','.','.','.','.','.','.','.','.','.','.','.','.','.','.','.','.','.','.','.','.','.','.','.','.','.','.','.','.','.','.','.','.','.'},
{'.','.','.','.','P','.','.','.','.','.','.','.','.','.','.','.','.','.','.','.','.','.','.','.','.','.','.','.','.','.','.','.','.','.','.','.','.','.','.','.','.','.','.','.','.','.','.','.','.','.','.','.','.','.','.','.','.','.','.','.','.','.','.','.','.','.','.','.','.','.','.','.','.','.','.','.','.','.','.','.'},
{'.','.','.','#','#','#','#','#','#','#','.','.','.','.','.','.','.','.','#','#','.','.','.','.','.','.','.','.','.','.','.','.','.','.','.','.','.','.','.','.','.','.','.','.','.','.','.','.','.','.','.','.','.','.','.','.','.','.','.','.','.','.','.','.','.','.','.','.','.','.','.','.','.','.','.','.','.','.','.','.'},
{'.','.','.','.','.','.','.','.','.','.','.','.','.','.','S','.','.','.','.','.','.','.','.','.','.','.','.','.','.','.','.','.','.','.','.','.','.','.','.','.','.','.','.','.','.','.','.','.','.','.','.','.','.','.','.','.','.','.','.','.','.','.','.','.','.','.','.','.','.','.','.','.','.','.','.','.','.','.','.','.'},
{'.','.','.','.','.','.','.','.','.','.','.','#','#','#','#','#','#','#','.','.','.','.','.','.','.','.','.','.','.','.','.','.','.','.','.','.','.','.','.','.','.','.','.','.','.','.','.','.','.','.','.','.','.','.','.','.','.','.','.','.','.','.','.','.','.','.','.','.','.','.','.','.','.','.','.','.','.','.','.','.'},
{'.','.','.','.','.','.','.','.','.','.','.','.','.','.','.','.','.','.','.','.','.','.','.','.','.','.','.','.','.','.','.','.','.','.','.','.','.','.','.','.','.','.','.','.','.','.','.','.','.','.','.','.','.','.','.','.','.','.','.','.','.','.','.','.','.','.','.','.','.','.','.','.','.','.','.','.','.','.','.','.'},
{'.','.','.','.','.','.','.','.','.','.','.','.','.','.','.','.','.','.','.','.','.','.','.','.','.','.','.','.','.','.','.','.','.','.','.','.','.','.','.','.','.','.','.','.','.','.','.','.','.','.','.','.','.','.','.','.','.','.','.','.','.','.','.','.','.','.','.','.','.','.','.','.','.','.','.','.','.','.','.','.'},
{'.','.','.','.','.','.','.','.','.','.','.','.','.','.','.','.','.','.','.','.','.','.','.','.','.','.','.','.','.','.','.','.','.','.','.','.','.','.','.','.','.','.','.','.','.','.','.','.','.','.','.','.','.','.','.','.','.','.','.','.','.','.','.','.','.','.','.','.','.','.','.','.','.','.','.','.','.','.','.','.'},
{'.','.','.','.','.','.','.','.','.','.','.','.','.','.','.','.','.','.','.','.','.','.','.','.','.','.','.','.','.','.','.','.','.','.','.','.','.','.','.','.','.','.','.','.','.','.','.','.','.','.','.','.','.','.','.','.','.','.','.','.','.','.','.','.','.','.','.','.','.','.','.','.','.','.','.','.','.','.','.','.'},
{'.','.','.','.','.','.','.','.','.','.','.','.','.','.','.','.','.','.','.','.','.','.','.','.','.','.','.','.','.','.','.','.','.','.','.','.','.','.','.','.','.','.','.','.','.','.','.','.','.','.','.','.','.','.','.','.','.','.','.','.','.','.','.','.','.','.','.','.','.','.','.','.','.','.','.','.','.','.','.','.'},
{'.','.','.','.','.','.','.','.','.','.','.','.','.','.','.','.','.','.','.','.','.','.','.','.','.','.','.','.','.','.','.','.','.','.','.','.','.','.','.','.','.','.','.','.','.','.','.','.','.','.','.','.','.','.','.','.','.','.','.','.','.','.','.','.','.','.','.','.','.','.','.','.','.','.','.','.','.','.','.','.'},
{'.','.','.','.','.','.','.','.','.','.','.','.','.','.','.','.','.','.','.','.','.','.','.','.','.','.','.','.','.','.','.','.','.','.','.','.','.','.','.','.','.','.','.','.','.','.','.','.','.','.','.','.','.','.','.','.','.','.','.','.','.','.','.','.','.','.','.','.','.','.','.','.','.','.','.','.','.','.','.','.'},
{'.','.','.','.','.','.','.','.','.','.','.','.','.','.','.','.','.','.','.','.',.','.','.','.','.','.','.','.','.','.','.','.','.','.','.','.','.','.','.','.','.','.','.','.','.','.','.','.','.','.','.','.','.','.','.','.','.','.','.','.','.','.','.','.','.','.','.','.','.','.','.','.','.','.','.','.','.','.','.','.'}